000000000000000000000000000000000000000000000000000000000000000000000000000
000000000000000000000000000000000000000000000000000000000000000000000000000
000000000000000000000000000000000000000000000000000000000000000000000000000
000000000000000000000000000000000000000000000000000000000000000000000000000
000000000000000000000000000000000000222220000000000000000000000000000000000
222222220002000200020002000200000222111112222200000000000000000000000000000
111111110000000000000000000000000000000000000000000000000000000000000000000
110000000000000000000000000000000000000000000000000000000000000000000000000
110000000000000000000000000000000000000000000000000000000000000000000000000
100000000000000000000000000000000000000000000222222222222222222000000000000
122200000000000000000000000000000000000000222111111111111111111222200000000
111122000220002200022000222222222000000022111111111111111111111111122000000
100000000000000000000000000000000000000000000000000000000000000000000000000
100000000000000000000000000000000000000000000000000000000000000000000000000
122222222222000000000000000000000000000000000000022222222222222222222222222
111111111111200000000000000000000000000000000002211111111111111111111111111
111111111111122222222222222222222222222222222221111111111111111111111111111
111111111111111111111111111111111111111111111111111111111111111111111111111
111111111111111111111111111111111111111111111111111111111111111111111111111